//MAP CONVERTED BY dmm2tgm.py THIS HEADER COMMENT PREVENTS RECONVERSION, DO NOT REMOVE
"ae" = (
/obj/item/tool/wrench/big_wrench,
/turf/floor/dummy/cult/airless,
/area/template_noop)
"aw" = (
/obj/spawner/scrap/sparse,
/turf/floor/plating/under/airless,
/area/template_noop)
"aH" = (
/obj/spawner/scrap/dense,
/turf/floor/plating/under/airless,
/area/template_noop)
"aJ" = (
/turf/cave_mineral,
/area/template_noop)
"aK" = (
/obj/structure/closet/secure_closet/freezer/kitchen{
	req_access = list(150)
	},
/turf/floor/tiled/white,
/area/template_noop)
"bi" = (
/turf/floor/asteroid/cave,
/area/template_noop)
"by" = (
/obj/structure/bed,
/obj/item/bedsheet/hos,
/obj/item/reagent_containers/food/drinks/bottle/vodka,
/turf/floor/dummy/lino/airless,
/area/template_noop)
"bB" = (
/turf/floor/plating/under/airless,
/area/template_noop)
"bG" = (
/obj/spawner/lowkeyrandom,
/obj/machinery/light{
	dir = 1
	},
/obj/spawner/pack/rare,
/turf/floor/dummy/freezer/airless,
/area/template_noop)
"cW" = (
/obj/structure/closet,
/obj/item/clothing/under/turtleneck,
/obj/item/clothing/shoes/magboots/merc,
/obj/spawner/pack/cloth,
/obj/spawner/pack/cloth,
/turf/floor/dummy/lino/airless,
/area/template_noop)
"du" = (
/obj/machinery/shower{
	dir = 1
	},
/obj/structure/curtain/open/shower,
/turf/floor/dummy/freezer/airless,
/area/template_noop)
"dI" = (
/obj/structure/table/standard,
/obj/item/deck/cards,
/turf/floor/dummy/cult/airless,
/area/template_noop)
"dN" = (
/obj/spawner/junk,
/turf/floor/plating/under/airless,
/area/template_noop)
"dU" = (
/obj/spawner/junkfood/rotten,
/obj/machinery/light{
	dir = 8
	},
/turf/floor/dummy/cult/airless,
/area/template_noop)
"eg" = (
/obj/item/storage/deferred/crate/alcohol,
/obj/machinery/light{
	dir = 4
	},
/turf/floor/tiled/white,
/area/template_noop)
"eo" = (
/obj/item/stool,
/obj/effect/decal/cleanable/vomit,
/turf/floor/dummy/lino/airless,
/area/template_noop)
"fb" = (
/obj/structure/table/standard,
/obj/item/reagent_containers/food/drinks/bottle/vodka{
	pixel_x = 5;
	pixel_y = 17
	},
/obj/item/reagent_containers/food/drinks/bottle/vodka{
	pixel_x = 6;
	pixel_y = 7
	},
/obj/item/reagent_containers/food/drinks/drinkingglass{
	pixel_x = -5;
	pixel_y = 1
	},
/obj/item/reagent_containers/food/drinks/drinkingglass{
	pixel_x = -5;
	pixel_y = 15
	},
/turf/floor/dummy/lino/airless,
/area/template_noop)
"fM" = (
/obj/structure/table/standard,
/obj/item/reagent_containers/food/snacks/mint,
/obj/item/reagent_containers/food/condiment/saltshaker{
	pixel_x = -3
	},
/obj/item/reagent_containers/food/condiment/peppermill{
	pixel_x = 3
	},
/turf/floor/tiled/white,
/area/template_noop)
"gN" = (
/obj/structure/shuttle/engine/propulsion{
	icon_state = "propulsion_l"
	},
/turf/floor/asteroid/cave,
/area/template_noop)
"ip" = (
/obj/spawner/scrap/dense,
/turf/floor/dummy/cult/airless,
/area/template_noop)
"iw" = (
/obj/machinery/light,
/turf/floor/dummy/lino/airless,
/area/template_noop)
"iY" = (
/obj/structure/table/standard,
/obj/item/packageWrap,
/obj/item/reagent_containers/food/condiment/enzyme{
	layer = 5
	},
/obj/item/reagent_containers/food/condiment/enzyme{
	layer = 5
	},
/turf/floor/tiled/white,
/area/template_noop)
"js" = (
/obj/structure/bed,
/obj/item/bedsheet/hos,
/obj/spawner/booze/low_chance,
/turf/floor/dummy/lino/airless,
/area/template_noop)
"jP" = (
/obj/structure/table/rack,
/obj/spawner/tool/advanced/low_chance,
/obj/spawner/tool/advanced/low_chance,
/obj/spawner/tool_upgrade/low_chance,
/obj/spawner/tool_upgrade,
/obj/spawner/tool,
/obj/spawner/tool,
/obj/spawner/tool/advanced/low_chance,
/obj/spawner/tool_upgrade/low_chance,
/obj/spawner/tool_upgrade/low_chance,
/turf/floor/dummy/cult/airless,
/area/template_noop)
"kc" = (
/mob/living/simple_animal/hostile/bear,
/turf/floor/dummy/lino/airless,
/area/template_noop)
"kl" = (
/obj/machinery/shower{
	pixel_y = 32
	},
/obj/structure/window/basic{
	dir = 8
	},
/obj/structure/curtain/open/shower,
/turf/floor/dummy/freezer/airless,
/area/template_noop)
"kx" = (
/obj/spawner/closet/maintloot/low_chance,
/turf/floor/dummy/cult/airless,
/area/template_noop)
"kO" = (
/obj/structure/table/standard,
/obj/item/storage/box/drinkingglasses{
	pixel_x = 1;
	pixel_y = 4
	},
/turf/floor/tiled/white,
/area/template_noop)
"kW" = (
/obj/spawner/junk,
/turf/floor/tiled/white/techfloor_grid/airless,
/area/template_noop)
"lA" = (
/obj/machinery/microwave{
	pixel_x = -1;
	pixel_y = 8
	},
/obj/structure/table/standard,
/obj/machinery/light{
	dir = 8
	},
/turf/floor/tiled/white,
/area/template_noop)
"lO" = (
/turf/floor/dummy/freezer/airless,
/area/template_noop)
"mZ" = (
/obj/structure/closet/emcloset,
/obj/spawner/rig/damaged/low_chance,
/obj/spawner/voidsuit/damaged/low_chance,
/obj/spawner/voidsuit/damaged/low_chance,
/obj/spawner/rig_module/rare/low_chance,
/obj/spawner/rig_module/low_chance,
/turf/floor/dummy/cult/airless,
/area/template_noop)
"nu" = (
/obj/structure/table/rack,
/obj/machinery/light{
	dir = 1
	},
/obj/spawner/gun/energy_cheap/low_chance,
/obj/spawner/gun/cheap/low_chance,
/obj/spawner/gun_parts/low_chance,
/obj/spawner/gun/normal/low_chance,
/obj/spawner/gun_parts/low_chance,
/obj/spawner/gun_parts/low_chance,
/obj/spawner/gun_parts/low_chance,
/obj/spawner/gun_parts,
/turf/floor/dummy/cult/airless,
/area/template_noop)
"oL" = (
/obj/structure/closet,
/obj/item/tool/pickaxe/diamonddrill,
/obj/item/tool/pickaxe/diamonddrill,
/obj/item/storage/backpack/military,
/obj/spawner/pack/rare/low_chance,
/turf/floor/dummy/cult/airless,
/area/template_noop)
"oX" = (
/obj/spawner/junkfood/rotten,
/obj/machinery/light{
	dir = 4
	},
/turf/floor/dummy/cult/airless,
/area/template_noop)
"qa" = (
/obj/structure/window/basic{
	dir = 8
	},
/obj/machinery/shower{
	dir = 1
	},
/obj/structure/curtain/open/shower,
/turf/floor/dummy/freezer/airless,
/area/template_noop)
"qe" = (
/obj/machinery/door/airlock/maintenance_interior,
/turf/floor/dummy/cult/airless,
/area/template_noop)
"qA" = (
/obj/structure/closet,
/obj/item/clothing/mask/balaclava/tactical,
/obj/item/clothing/mask/balaclava/tactical,
/obj/spawner/pack/cloth,
/obj/spawner/rig/damaged/low_chance,
/obj/spawner/pack/cloth,
/obj/spawner/voidsuit/damaged/low_chance,
/turf/floor/plating/under/airless,
/area/template_noop)
"qL" = (
/obj/item/modular_computer/console,
/turf/floor/dummy/cult/airless,
/area/template_noop)
"qX" = (
/obj/machinery/door/airlock/maintenance_interior,
/turf/floor/dummy/freezer/airless,
/area/template_noop)
"rd" = (
/obj/structure/bed,
/obj/item/bedsheet/hos,
/obj/item/clothing/head/ushanka,
/turf/floor/dummy/lino/airless,
/area/template_noop)
"ru" = (
/obj/structure/shuttle/engine/heater,
/obj/structure/window/reinforced/crescent{
	dir = 1
	},
/turf/floor/airless,
/area/template_noop)
"rL" = (
/obj/item/reagent_containers/food/drinks/bottle/vodka{
	pixel_x = 3;
	pixel_y = 12
	},
/obj/item/reagent_containers/food/drinks/bottle/wine{
	pixel_x = -1;
	pixel_y = 8
	},
/obj/structure/table/standard,
/turf/floor/tiled/white,
/area/template_noop)
"sg" = (
/obj/structure/closet,
/obj/spawner/ammo,
/obj/spawner/ammo,
/obj/spawner/ammo,
/obj/machinery/light{
	dir = 1
	},
/obj/structure/closet/secure_closet/rare_loot,
/turf/floor/dummy/cult/airless,
/area/template_noop)
"ss" = (
/obj/structure/table/rack,
/obj/item/storage/deferred/meds,
/obj/spawner/surgery_tool/low_chance,
/obj/spawner/medical/low_chance,
/obj/spawner/medical/low_chance,
/obj/spawner/medical/low_chance,
/obj/spawner/medical,
/obj/spawner/medical_lowcost,
/obj/spawner/medical_lowcost,
/obj/spawner/medical_lowcost/low_chance,
/obj/spawner/medical_lowcost/low_chance,
/turf/floor/dummy/cult/airless,
/area/template_noop)
"sN" = (
/obj/structure/bed/chair{
	dir = 1
	},
/turf/floor/dummy/cult/airless,
/area/template_noop)
"tv" = (
/obj/structure/table/rack,
/obj/spawner/gun/shotgun/low_chance,
/obj/spawner/gun/normal/low_chance,
/obj/spawner/gun_parts/low_chance,
/obj/spawner/gun_parts/low_chance,
/obj/spawner/gun_parts,
/turf/floor/dummy/cult/airless,
/area/template_noop)
"tK" = (
/obj/item/remains/human,
/obj/item/clothing/shoes/magboots/merc,
/obj/item/clothing/under/turtleneck,
/obj/item/clothing/head/ushanka,
/turf/floor/tiled/white,
/area/template_noop)
"um" = (
/obj/item/stool,
/turf/floor/dummy/airless{
	icon_state = "cult";
	name = "plating"
	},
/area/template_noop)
"vt" = (
/obj/machinery/portable_atmospherics/canister/plasma,
/turf/floor/dummy/cult/airless,
/area/template_noop)
"vz" = (
/obj/structure/table/standard,
/obj/item/reagent_containers/glass/beaker{
	pixel_x = 5
	},
/obj/item/reagent_containers/glass/beaker{
	pixel_x = 5
	},
/obj/machinery/light,
/obj/item/material/kitchen/rollingpin,
/turf/floor/tiled/white,
/area/template_noop)
"vP" = (
/obj/machinery/mech_recharger,
/obj/spawner/exosuit/damaged,
/obj/spawner/exosuit_equipment/low_chance,
/obj/spawner/exosuit_equipment/low_chance,
/turf/floor/dummy/cult/airless,
/area/template_noop)
"wR" = (
/obj/structure/table/rack,
/obj/spawner/pouch/low_chance,
/obj/spawner/pouch/low_chance,
/obj/spawner/pouch/low_chance,
/obj/spawner/pouch,
/obj/spawner/pouch/low_chance,
/obj/spawner/cloth/belt/low_chance,
/obj/spawner/cloth/belt/low_chance,
/turf/floor/dummy/cult/airless,
/area/template_noop)
"wU" = (
/obj/machinery/door/airlock/maintenance_interior{
	icon_state = "door_locked";
	locked = 1
	},
/turf/floor/dummy/airless{
	icon_state = "cult";
	name = "plating"
	},
/area/template_noop)
"wX" = (
/obj/structure/table/standard,
/obj/item/folder/cyan,
/turf/floor/dummy/cult/airless,
/area/template_noop)
"xN" = (
/obj/spawner/soda/low_chance,
/turf/floor/tiled/white,
/area/template_noop)
"yE" = (
/obj/machinery/door/airlock/maintenance_interior{
	icon_state = "door_locked";
	locked = 1
	},
/turf/floor/dummy/cult/airless,
/area/template_noop)
"yJ" = (
/obj/item/stool,
/obj/spawner/booze/low_chance,
/turf/floor/dummy/cult/airless,
/area/template_noop)
"zg" = (
/obj/structure/table/standard,
/obj/spawner/booze/low_chance,
/turf/floor/dummy/cult/airless,
/area/template_noop)
"zJ" = (
/obj/item/stool,
/obj/spawner/junkfood/rotten,
/turf/floor/dummy/cult/airless,
/area/template_noop)
"zM" = (
/obj/item/stool,
/turf/floor/dummy/cult/airless,
/area/template_noop)
"zT" = (
/obj/structure/shuttle/engine/propulsion,
/turf/floor/asteroid/cave,
/area/template_noop)
"As" = (
/obj/item/stool,
/turf/floor/dummy/lino/airless,
/area/template_noop)
"Bq" = (
/obj/structure/toilet{
	dir = 8
	},
/turf/floor/dummy/freezer/airless,
/area/template_noop)
"Bv" = (
/obj/structure/bed,
/obj/item/bedsheet/hos,
/obj/item/clothing/under/serbiansuit/brown,
/obj/spawner/oddities/low_chance,
/turf/floor/dummy/lino/airless,
/area/template_noop)
"Bz" = (
/obj/item/stool,
/obj/spawner/booze/low_chance,
/turf/floor/plating/under/airless,
/area/template_noop)
"BQ" = (
/obj/structure/table/standard,
/turf/floor/tiled/white,
/area/template_noop)
"CY" = (
/obj/machinery/light,
/obj/spawner/closet/maintloot/low_chance,
/turf/floor/dummy/cult/airless,
/area/template_noop)
"Di" = (
/obj/spawner/closet/maintloot,
/turf/floor/dummy/cult/airless,
/area/template_noop)
"DP" = (
/obj/structure/bed,
/obj/item/bedsheet/hos,
/obj/spawner/oddities/low_chance,
/turf/floor/dummy/lino/airless,
/area/template_noop)
"Ee" = (
/obj/structure/table/standard,
/obj/item/paper_bin,
/obj/item/pen,
/turf/floor/dummy/cult/airless,
/area/template_noop)
"Eg" = (
/obj/machinery/door/airlock/maintenance_interior,
/turf/floor/dummy/airless{
	icon_state = "cult";
	name = "plating"
	},
/area/template_noop)
"Eo" = (
/obj/structure/bed,
/obj/item/bedsheet/hos,
/obj/item/clothing/under/serbiansuit,
/turf/floor/dummy/lino/airless,
/area/template_noop)
"EL" = (
/obj/machinery/door/firedoor,
/turf/wall/low/with_glass/reinforced,
/area/template_noop)
"Fj" = (
/obj/structure/closet/secure_closet/freezer/fridge,
/turf/floor/tiled/white,
/area/template_noop)
"FH" = (
/mob/living/simple_animal/hostile/bear,
/turf/floor/tiled/white/techfloor_grid/airless,
/area/template_noop)
"FS" = (
/turf/floor/tiled/white,
/area/template_noop)
"Ga" = (
/obj/machinery/shower{
	pixel_y = 32
	},
/obj/item/soap/deluxe,
/obj/structure/curtain/open/shower,
/turf/floor/dummy/freezer/airless,
/area/template_noop)
"Gy" = (
/obj/spawner/scrap/sparse,
/turf/floor/dummy/cult/airless,
/area/template_noop)
"Hn" = (
/obj/structure/lattice,
/turf/floor/asteroid/cave,
/area/template_noop)
"Hs" = (
/obj/spawner/closet/maintloot/low_chance,
/turf/floor/plating/under/airless,
/area/template_noop)
"Ib" = (
/mob/living/simple_animal/hostile/bear,
/turf/floor/tiled/white,
/area/template_noop)
"IG" = (
/mob/living/simple_animal/hostile/bear,
/turf/floor/plating/under/airless,
/area/template_noop)
"Jp" = (
/obj/spawner/junkfood/rotten,
/turf/floor/tiled/white,
/area/template_noop)
"Km" = (
/obj/structure/girder,
/turf/floor/plating/under/airless,
/area/template_noop)
"La" = (
/obj/machinery/light{
	dir = 4
	},
/turf/floor/dummy/cult/airless,
/area/template_noop)
"Mb" = (
/obj/structure/table/standard,
/obj/item/device/lighting/toggleable/lamp,
/turf/floor/dummy/lino/airless,
/area/template_noop)
"Nt" = (
/obj/structure/sink/kitchen{
	pixel_y = 26
	},
/turf/floor/tiled/white,
/area/template_noop)
"Ou" = (
/obj/structure/table/standard,
/obj/machinery/reagentgrinder/portable,
/turf/floor/tiled/white,
/area/template_noop)
"Pa" = (
/obj/structure/table/standard,
/obj/machinery/chemical_dispenser/soda{
	pixel_x = 2;
	pixel_y = 6
	},
/turf/floor/tiled/white,
/area/template_noop)
"Pp" = (
/obj/machinery/portable_atmospherics/canister/oxygen,
/turf/floor/dummy/cult/airless,
/area/template_noop)
"PH" = (
/obj/machinery/shower{
	pixel_y = 32
	},
/obj/structure/curtain/open/shower,
/turf/floor/dummy/airless{
	dir = 2;
	icon_state = "freezerfloor"
	},
/area/template_noop)
"PN" = (
/obj/structure/table/standard,
/obj/item/deck/cards,
/turf/floor/dummy/lino/airless,
/area/template_noop)
"PO" = (
/obj/spawner/junk,
/turf/floor/dummy/freezer/airless,
/area/template_noop)
"Rh" = (
/obj/structure/mirror/antag{
	pixel_x = -28
	},
/obj/structure/sink{
	dir = 8;
	icon_state = "sink";
	pixel_x = -12;
	pixel_y = 2
	},
/turf/floor/dummy/freezer/airless,
/area/template_noop)
"RC" = (
/obj/spawner/junk,
/obj/machinery/light{
	dir = 8
	},
/turf/floor/dummy/freezer/airless,
/area/template_noop)
"So" = (
/obj/structure/urinal{
	pixel_y = 32
	},
/turf/floor/dummy/freezer/airless,
/area/template_noop)
"Sy" = (
/obj/machinery/light{
	dir = 8
	},
/turf/floor/dummy/cult/airless,
/area/template_noop)
"Vq" = (
/obj/machinery/light{
	dir = 4
	},
/turf/floor/tiled/white/techfloor_grid/airless,
/area/template_noop)
"Vt" = (
/obj/spawner/junk,
/turf/floor/dummy/cult/airless,
/area/template_noop)
"VJ" = (
/turf/floor/dummy/lino/airless,
/area/template_noop)
"Wj" = (
/obj/spawner/junk,
/turf/floor/tiled/white,
/area/template_noop)
"WC" = (
/obj/machinery/light_construct{
	dir = 8
	},
/turf/floor/plating/under/airless,
/area/template_noop)
"WH" = (
/obj/structure/table/standard,
/obj/item/device/lighting/toggleable/lamp,
/turf/floor/dummy/cult/airless,
/area/template_noop)
"Xm" = (
/obj/structure/shuttle/engine/propulsion{
	icon_state = "propulsion_r"
	},
/turf/floor/asteroid/cave,
/area/template_noop)
"Xv" = (
/obj/spawner/junk/low_chance,
/turf/floor/plating/under/airless,
/area/template_noop)
"Yj" = (
/obj/structure/table/standard,
/obj/item/storage/deferred/rations,
/obj/machinery/light,
/turf/floor/dummy/cult/airless,
/area/template_noop)
"Yp" = (
/obj/item/stool,
/obj/spawner/junkfood/rotten,
/turf/floor/dummy/lino/airless,
/area/template_noop)
"YW" = (
/turf/floor/dummy/cult/airless,
/area/template_noop)
"YZ" = (
/turf/wall/reinforced,
/area/template_noop)
"Zt" = (
/obj/structure/table/rack,
/obj/spawner/gun/normal/low_chance,
/obj/spawner/gun/energy_cheap/low_chance,
/obj/spawner/gun_parts/low_chance,
/obj/spawner/gun_parts/low_chance,
/obj/spawner/gun_parts,
/turf/floor/dummy/cult/airless,
/area/template_noop)
"ZY" = (
/mob/living/simple_animal/hostile/bear,
/turf/floor/dummy/cult/airless,
/area/template_noop)

(1,1,1) = {"
aJ
aJ
aJ
aJ
aJ
bi
aJ
aJ
aJ
aJ
bi
aJ
aJ
aJ
aJ
aJ
aJ
bi
bi
bi
bi
bi
bi
bi
bi
"}
(2,1,1) = {"
aJ
aJ
aJ
aJ
bi
bi
bi
aJ
aJ
bi
bi
bi
aJ
aJ
aJ
aJ
bi
bi
bi
YZ
YZ
YZ
YZ
bi
bi
"}
(3,1,1) = {"
aJ
bi
bi
bi
bi
bi
bi
bi
bi
bi
bi
bi
bi
bi
bi
bi
bi
bi
YZ
YZ
Ee
WH
ru
gN
bi
"}
(4,1,1) = {"
bi
Hn
YZ
YZ
YZ
EL
YZ
YZ
Km
Hn
bi
bi
Hn
Hn
Km
YZ
YZ
EL
YZ
qL
sN
YW
ru
zT
bi
"}
(5,1,1) = {"
bi
bB
Eg
Vt
YW
YW
La
ip
bB
bB
Hn
Hn
aw
IG
bB
YW
La
YW
qe
YW
oX
ZY
ru
gN
bi
"}
(6,1,1) = {"
Hn
Km
YZ
YZ
YZ
YZ
YZ
YZ
YZ
YZ
wU
YZ
YZ
YZ
YZ
YZ
YZ
YZ
YZ
YZ
YZ
Pp
ru
zT
bi
"}
(7,1,1) = {"
bi
Hn
YZ
cW
VJ
Yp
PN
As
YZ
kx
YW
vP
YW
mZ
YZ
Fj
lA
BQ
rL
kO
YZ
vt
ru
Xm
bi
"}
(8,1,1) = {"
bi
aw
YZ
Mb
VJ
VJ
VJ
iw
YZ
nu
YW
YW
ae
kx
YZ
Jp
Jp
tK
xN
fM
YZ
YZ
YZ
bi
bi
"}
(9,1,1) = {"
bi
Hn
YZ
by
VJ
kc
VJ
js
YZ
wR
ZY
um
zJ
zM
YZ
Nt
Ib
Wj
xN
iY
YZ
YZ
Hn
bi
aJ
"}
(10,1,1) = {"
bi
bi
YZ
js
VJ
VJ
VJ
DP
YZ
oL
YW
wX
zg
Yj
YZ
Ou
FS
FS
FS
vz
YZ
bi
Hn
aJ
aJ
"}
(11,1,1) = {"
bi
Hn
YZ
js
VJ
VJ
VJ
rd
YZ
qA
bB
Bz
zM
yJ
YZ
Pa
FS
FS
eg
aK
YZ
Hn
Hn
aJ
aJ
"}
(12,1,1) = {"
Hn
Km
YZ
YZ
YZ
Eg
YZ
YZ
Km
Hn
Hn
bB
bB
kx
YZ
YZ
YZ
wU
YZ
YZ
Km
Hn
aJ
aJ
aJ
"}
(13,1,1) = {"
Hn
bB
Eg
YW
Sy
YW
Vt
YW
wU
Xv
Hn
Hn
IG
Vt
yE
ZY
Sy
YW
Vt
bB
Hn
bi
aJ
aJ
aJ
"}
(14,1,1) = {"
Km
YZ
YZ
YZ
YZ
Eg
YZ
YZ
YZ
Hs
bB
bB
bB
kx
YZ
YZ
YZ
Eg
YZ
Km
bB
Hn
bi
aJ
aJ
"}
(15,1,1) = {"
Hn
aH
YZ
js
bB
Hn
bB
Eo
YZ
sg
ZY
zM
yJ
zM
YZ
So
RC
lO
Rh
bB
Km
Hn
Hn
aJ
aJ
"}
(16,1,1) = {"
bi
Hn
YZ
Bv
IG
bi
Hn
js
YZ
jP
YW
zg
dI
zg
YZ
So
lO
lO
PO
lO
YZ
bi
Hn
bi
aJ
"}
(17,1,1) = {"
bi
bi
YZ
js
bB
bi
bB
js
YZ
ss
YW
zJ
zM
zM
YZ
kl
kW
qa
YZ
qX
YZ
YZ
Hn
bi
aJ
"}
(18,1,1) = {"
bi
bi
YZ
Mb
VJ
bB
kc
iw
YZ
Zt
ZY
YW
YW
CY
YZ
Ga
FH
du
YZ
bG
YZ
YZ
YZ
bi
bi
"}
(19,1,1) = {"
bi
Hn
YZ
cW
VJ
eo
fb
eo
YZ
tv
YW
kx
Gy
Di
YZ
PH
Vq
du
YZ
Bq
YZ
vt
ru
gN
bi
"}
(20,1,1) = {"
bi
Km
YZ
YZ
Km
Km
Km
YZ
YZ
YZ
yE
YZ
YZ
YZ
YZ
YZ
YZ
YZ
YZ
YZ
YZ
Pp
ru
zT
bi
"}
(21,1,1) = {"
bi
bB
Eg
aw
dN
Hn
Hn
bB
bB
YW
YW
Sy
YW
ZY
bB
bB
WC
YW
qe
YW
dU
YW
ru
gN
bi
"}
(22,1,1) = {"
bi
Hn
YZ
YZ
YZ
Hn
bi
Hn
Km
EL
YZ
YZ
YZ
EL
Km
Hn
Km
EL
YZ
qL
sN
YW
ru
zT
bi
"}
(23,1,1) = {"
bi
bi
bi
bi
bi
bi
bi
bi
bi
bi
bi
bi
aJ
aJ
bi
bi
bi
bi
YZ
YZ
wX
WH
ru
Xm
bi
"}
(24,1,1) = {"
bi
bi
bi
aJ
aJ
aJ
aJ
bi
bi
bi
bi
aJ
aJ
aJ
aJ
bi
aJ
aJ
bi
YZ
YZ
YZ
YZ
bi
bi
"}
(25,1,1) = {"
bi
bi
aJ
aJ
aJ
aJ
aJ
aJ
bi
bi
aJ
aJ
aJ
aJ
aJ
bi
aJ
aJ
aJ
bi
bi
bi
bi
bi
bi
"}
